###########
#@.m#.mm..#
#..m#..v..#
#..m#.....#
##.##.....#
#.....b...#
#m........#
#...#.#####
#...#.....#
#mv.#mm..v#
###########