###########
#m.......@#
####..#####
#mm.....v.#
#####.....#
#..v......#
#...####.##
#v..#.b...#
#.........#
#mmm#..mmm#
###########