###########
#mmm.....@#
#.###.....#
#..v...mm.#
#.b..###..#
#......v..#
#.###.....#
#.v.m..#..#
#..##...m.#
#.mm......#
###########