###########
#..#vmmmmm#
#...#.....#
#.v..#.b..#
#....#....#
#mmm......#
#.........#
###.###..@#
#.v....####
#mm.......#
###########