###########
#.vmm#.vmm#
#....#....#
###.####.##
#.........#
#@.###.mm.#
#.........#
#####.##.##
#.b.....v.#
#mmm......#
###########