###########
#.v.mm#m@m#
#.mm..#.b.#
###.###...#
#......mm.#
#...v.....#
#.######..#
#.........#
#....###m.#
#.v.......#
###########